128 128
00000002200000200000000000000000000000000000000000000000400000000000000000000000000000000000000000000000000000000000000000000033
00000030250000000500333330000000000000000000000000000200440000000000000020000000000000000000000000000000000003000000000033000000
00000000200000000000033330000000000000000000000000000020004000000000003002000000040000200000000000000000300003300400000033300000
30000222220000000000002000000000000000000000000000000020000400000400003002200000000000022000200000000000000000000000000000000000
00000402222000000300000200040000000000000000000000000002200000000000000000200000000000002200002000000000000000000000000000004000
00404400222000000000000020004000000000003000000000000000000000000000000000200000000400000000002203000000000000000000000000000000
30000400022000004000000000004000000000000300000000000000033330020000240000222000040000000000000225300033000000000000000000000030
00000044400000000000000000000000000000000000000000000000043333002050000000022200000000005000000022000333000000000000000002222333
00000000040000000000000004040000000000040000000000000400000333002200000000002222000000400000000002000033000300000000000000400333
00000000004000000000000000000000200000000000000000000400000032030000000033000222000000000000000000000033000000200000000000040333
00000000300000000000440000000000000000000400040400000040000000220000000000000002400030000000000044000003220000000000000000000333
00000004433300000000044000000000040000000000000400300000000000000000000000000000040200220000000044000003222000000003000000000033
00000000033330000000000040000000330030000000000003300020005000000000000000000030000020022000000000000000222200000000300000000003
30000000003330000000000300000000033003300000000022330300000000000000000000000003000000404000000000000000222222200000000000000000
03000000003330000000000000000000003000330000000032003000000000000000054000003003300000440000000000000000002222200000000000000000
00000000004033304000000000000000000005333000000000000330000044000300000000000003300000000000000000000000000022222000000000000000
40000000000000000000000000000000000000433300000400000033300000000000000000000000000020000000000000000330000000000000000004400000
30003000000000300000000004000000000000003330000000000000003000000000000000000000000020000000000004050330000000000000000440000000
00000300000000000000000000400000400000000400000000000000003304400000000040000000000202000000000040000032000000000000000040000000
20000000000003000000000000000000444000000040000000000000000330500002000004000000000000000000000000000030000000000000000000000000
00000000000000033000000000000000000000000000000000004000000033303002200000400000000000000020000000000003030000000200000000000000
00000000002400003303000000000000000000000000000000004400330400030002222200000000000000040022023000000000003000000000000000000000
04003300002220000003300000000000030000400000000000030000000000033000002220000000000000000022202000000000003300005000000000000000
04400000000020300000440000000000030000440000000000000000000000003000000222000000000000000002200000050000003332000000000000000000
00040000000020000000000000000000030000044000000000000000000000000000000002202000300000400000000000000000300400300300022004000000
00000000000400000000000000000000000033004400000000000000000000000000000002222204000000000000000000000000000040000300000000000400
00000000000000000000000000002200000033400000000000000040000000000000000000022220400000000000000000000000000000000000000040000000
00000000300000000040400000000220000003444000000400000000000000000000000000004420033000000000000000000000004400000000000000000000
00000000000000000000040000000004000000034400000040000000000000000000000000000440000300000040000000000000000000000000000000000000
00000000000000022200000400000000000000000440000000000000400000000000000000000044000000000044000000000000000000000000040200000000
00000000000200002220000500000000000000000000000000004000022000000000322000000044403000000000000000000022000000000000000000000033
00000000000200000002000000000020000000000000004400004000300000000000032000000000000000000000304000000000000000000000000000000033
00000000000220003320000000020000000000000000030040000000000000000000003000000000000000000030000003000000000000000000000000000200
00000000000020000000000000000000000000000000003044000000000000000000000000000000200000000003300000300003000000000000220002200220
00000000000000000000000000000000000000000000000300000000000200044000004000000000020000033220300000330000000000000000220002424423
00000000000000000000000000000000000000000000000000000000000200004400000000002200002000003220033000033000000004000000000002002433
00050220000000000000000000000000000000200400000003000000000220004400000000000200000000003022000000000333000000444000000000003050
00033222000000222002000003000000000000000000400000300000000000000440000000000000000000000302203303000333000000044444004000000000
00000003000000022200200000000000000000000000000000000000000000000044000000000000000000030300000333300003300000000444000444000000
00000000000000000020000000400040000003000000000000000000030033000004400000000000000000033000000000330000000000000004400444000000
00000000000000000020000030000000000003300000033000000000033000000000000000030000000000000400000000030000000000000000444444444000
00000000000300000002000003000000003303300000000000000000003000000044400003000000000020004400004400003330000000000000444444444440
00000000000000000000000000000000040000030000200000000000002000040000440000000000000002200400000000000030000000000000000000444444
00500000000000002200333000000000000000030000022000000000000200000000000000000000002004200000330000000003003300000000000000004444
00000000000300040000000000000000000000000000022000000000000200000000000000000300000000000004400000000040000330022000000000000444
00000000004400000000000000000000000000000000000200000000000020000000000000000330000000000004440000000044000000022200000000000044
00000000004440000000000300000000000000000000000000000000000020000000000000000000400000000000000000300004400000005000000000300020
00000044004444000000000000500000000000030000000002220000000000000000000000000000440000000000000000000004440000000000000000000030
00000044400444400000330033003300300000033000000000022000000000000000000000000000000000002000000040300004440030000000000000300000
00000000440344400000033033303300000000033333003000002200000000000000000200000000000004002000300004000000000030000000000003030000
00000000040004400304033003300400000000000333000300000000000000004000030200000000000000000000033000000000000000000000000030000002
04400000000004400000440020330000000000000333330030000000000000004440000200000000000004400000003003300000000000000000000003000000
04444000000000444000044000030500000000000033330000003000000000000444000022200000500000440000003300330000000000000000300000000004
00004000000000044000000444000000000000000443330000000000000000050004404422200000000000244000000300000000000000040000030000033002
00004000000000044000000044400000000000000040333000000400000000000002000000000000000000004400000000000000000000000000003004403000
00000030000000000000000004444000000000000000003000000040200000000000000000000000000000003440000000040000000000000000403300400000
00000003000000000000000000044400000000000000400000000044020000000000000000000000000000003043000000000000000000040402003333000000
03340000002200400000022200044440000000000000000030000000000000000000003300000002230000000003333000000000030000000040000333300004
00330000005200000000000200000300000000000000000000000000000000000000004300000002220000000000333000000000030000000000000033330000
00330000000000400000000200000000000040000004004440000000000000000002000003040002224000000000033300000003000000000000000003330030
00003300000040400000000000000002000000300004440044000000003000000000000000300002224000000000443330000000000000000030000000200000
00000002220003303000000000000000440003300000040000000000000000000000004000000002220000000000000030000000000000000000003000000000
00000000222203333440000000000000004000030000000000000000300000000000300000000000222000000000000000000000000000000030000000000000
00000000000222033000000000300000000000033300000000020000330000000000000000000000022220000000000000000000000000000200000000000000
00000000000022003340000400000000000000000330000000020000400000400000000000000000000424000000040000000000000000000000200000000000
00000000000000000344000400000003000000200223330000200000000000444003200000000003000020000004004000020000000000000000000000000000
00000000000004000034000000000000000000002002330000200000000000004033330000000000000020000000400022000000000000000000000003000000
00000000000004000030000000000000000000000000233004000000000000000033333000000000440040000000000022000000000000000000000000000000
00030000000000000030032500000000000000000000022033000000000003003000333000000000000000000000004000000000000000000000000000000000
00000000000000044440000200000000000000000000000033300000000003000000000000000000000000000000000400000000000000000000003000000000
00000000330000000044403020000000000000000000000003300430000000000000000000000000000000000003000040000000000000000000000000000000
00000004033000020004400024000000040000000003000003300430003000000000000000040000000000000003000000000000000000000000000000400000
00000004003300000000440022000000000000044044000003300000200000300000000000004320000000000200334000000000000400000000000000200000
00000000000340000000040002200000000000000004400200333000220000000005000000000032000000400020033400000000000000000000000000200000
00000000000444000000044002220000002000300000044000033330020000400000040000000030000000000000003400000000333000000000000000200000
00000000000044000004000040220000000000030000000000003330002222000000344000000000000000000000022200000000003000000000000003030000
00000200000004000000400040002000000023003000000000000003000022003000000000000000000000000000000200000000004300000000000000030000
00000000000000000000404000000000004022203000000400000004300002400000000300000000000000000000000020000000000000000050000000003030
00000000000033000000440000000000000022200300000000000000440002000000000300000003000000000000044002000000000000000000200000003033
00400000000000000000040000000000000003300000000000000000444002000300000300000040000000000000004002200000000000000000000000003000
00000000000000000004000333300000000003330000000000000000044000000000000300000000000000000004000000230000000000400000002000033020
00000000000000000000000333320000040044000000000000003000000000000000000000000000300000000004400000220000000000040000000200200002
00000003000000000000000033330000000000000000300000003300000000000000020000000000300000000004440000220000000000000000000000220000
00300000002200000000000033333000000000000000330000000300000000000003422200000000000333000000044440022220000000000000000000220000
00000000000000000000000003333000000300000000000000000000003330000000302220000000000033330000004440022222000000000003000000020000
00000000000000000000000000333000000000000000000000004000000330050000032220000000020000000000005004400044000000000000004400022000
00000004400000000000050000333034000000003300030000000000000333033000000000000000002000000004200000400004000000000004000044402200
00300000000000000000000000033334000000003400000000000000000003000304000000000000002400000000420000040000000030000000000400000000
00030000400000000000000000003333004000000000000000000000000000000000000000500000030040004000044000004400000000000000002400000300
00000000033000000000000000000400000000000000000000000000004000000440000000000000000040000000004000004440040000000000002400000020
00000000033300000000000000022000000000000000000000040000440000000444000000032000000004000000000000000000004000000000002200000022
00000000003330000000000000004000000000000000000003000000040000000004000000030000000000000000000033300000000000000000040500000002
00004000000330000000000000050003050000000000000000000030000000505000000000000000000000000030040003330200200000000000444000000002
20000000000030000504030000330003000000000000000000040000040000000000000000000000000030000030000000330000020000000000000000000000
20000300000003040000000000000000000050000000000000000000300000000000000000000000000040000000000000000000002240000000000000000000
44000000002400304300000002400000000000440000000000000000000000000000000000000000000000000000000000030000000404000000000400000000
00000000000040200440000000000000000000004000000000000000000000000000000300004000000000000000000000000000000004000000000040000000
00000204000044000000000030000000000000000000000000000000000000000000000000000000004400000033300000000000000004000000000000000000
00000000400000000000000033004000000333000000000000000000000030000400000000000000000000000000333000000000300000000000044203040000
00040200000000000004004003300000000000300200000000000000000033000040004000000003333300000000333000000000000000000000004000300004
00000222000000000000000000344000000040000000000000000000000003300000004000000220003300000000003000000000033000000000000003000000
00000002200000000000000000304500022000000200000000000030000000030000000030000022200000000000000303000000044000000000000000000000
00000000000020000000000000430000022200004022000000000003330000000000000003000002240000500000000000000000000000000000000000000000
00000003000002000000000000000000002200000402000000000000000000003300000000000000000040000000000000000000000000000000400000000000
00000000300000000000003003000000003322000440050000000300000000003300000000000000000000000000000040000000000004000000000000000003
00003440000000000000000333040054004022200003000000000000005000000000000033000300000000000000000000000000000444000000000000000000
00003344000000000004000033004000000400000000000000000000000000000000000000003035200000000000000000000000000444403000000000400000
00000204000000040000000003004000000000000000000200000000000000000000000000000033320000000000000000000000000000003000000000000000
00000004400000044000000020000000000000000040000000000000000000000000000000000000330000000000000004000000050022000000000000000000
00000004440000004000000002200000000000020040002000000020003000000000000000000000330000000000000000000000040000220400000000000040
00000000440000000440000000020000200000022200000000000000003300000000000000000000000000000000000000000000000000330000000000000040
00000000000000000004400033000002000000002200000000000000000034000504000000000333000030000040000000000000000000000000000000000000
00000000000000000000000033300000000400000222000000000000000033003330000000000033000030000044000000000000000030000000000000200000
00000000050000000000000003333000030400000022000000000000000033330030000020000000400003000003444000000000000000000000000000020004
00000000000200000000000000334000004000000002220002240000020003340000000002000000044000000003344000000025000000400005000004000000
43000000000022000000000000020220004402000002222000220000000000040004000000000044000000000003333000000000000000040000003040003000
03300000000022200000000330000002004400222000022200000000000044400004403304400004000000000000500300000000000000000000000000000300
00333000000002220000000020000000004400222000022220000000000004400000000004400204400002000400000300000004000000000000000000000000
00333000000002222000000020000000000000044000022222000000000004400200004004400000444400000000000000004000000000000000000000000000
00333000400002222200000000004020000000004405002222200000000000440000000004400000044440000000000000000400000000000000400000000004
00333330040000022220000000004442500000000000035222204000000000044000000200400000004444000000000000050000000000000000000000000000
00000333000000002220000000000444440000000000000000030000000000044400000020000000030044444000000000000000000000000000000000300000
00000033300000000002200000000444444000000000000000000000000000004400000000000000000000044404000000000000003000000000000500333300
00000033300000000000000000000044444433000000000000304000000000000440000000000000000000004400000034000400000300000000003000033333
00000000300000000000000000000044444400000000000000030400000000400004000000000000000000000040000004000000000000003300000000003333
03000000000022000000000000000004444400000000000000003044000000000400400000000000000000000040000000400000000000000340000000003403
03304000000002200020000000300000044440004000000000000004400000000000040000000000000000000000000000044000000000000000000000000003
00000000000002200022000000030000004440400400000000002000440000000000000000000000000000000000000000044444003300000000000000000040
