32 32
00300000000320300000000004000000
00000000444030030000000000400000
00000000000400033330000000400000
00000000000400000040000000040000
00000000500000000044000000000440
30000000000000000000000000000440
00000000003000000000000440000444
00000000000000000000000000000000
00000000000000000000000000000000
04000444002000000000400000000000
04400444402000000000443330000000
04444444440244000000003333000000
40044444444024400000003333000000
00300444444402244040000033300000
00300444444402222000000000000000
02330044444442222000000000000000
00333004444444444000000000000000
00333300444444444400000000000000
00033330004444500400000000000000
00000000004444400000000000005000
00300000000000000000040000000000
00000000000000000000000000000000
00000000000000000000000000000000
00000000035000045000000000000000
00000000000000000000000000004300
00000000000000000000030000000300
00030000000000000000003000000333
00040000000050000440000300000003
03040000000000000000000033000000
00000000000040040000000003300000
00000000000044004000000000300000
00000000000004400200000000000000
