128 128
00000300000000004000000000000000003000000000000000000004000000000000000000000000000004000000000000000000000000000000000000400040
00000000000002004000000000000000000330000000000000000000000000003000000000000440000004400030000000000000002000000000000000440000
00033000000002000000000000000044440003000000000000000000000000000000500000000444000000000003000000003300000222332000000000000000
00000000000000000000000000000004454000330000000000200000000000000040000000040044500000002000000000000330000000232000000000000000
02000000000000000020020000000000440000000000002220200000000000000044000000000000000000000000000004400330040000000000000000000000
00000000000030000042002000000000000000000000000220000000000000030000000000000000000000000000000000440034000004000000000000000000
00000000000003000000200200000000000000000000000020000000000000033300004000000020000000003300000000000033300040300000000400000000
00000000000004000000422222000000000000000000000002000000000000000000000000000002030000000333000000000433330004000000000000040000
00000400000000000000000222000004000000030000000000200000002200000000002200000000033200000000000400000032230300000000000000204000
00000000000000000300000222200004430000000000000000020000002200043000002200000000000020000000000400000033223300000000000000220400
00000000000000000000000222220000033300000000000044440000000000002300000004000220000054000000000440000000220300000000000000000040
00033330033004000040000022220004003300000000000004440030000000000220000000000222000200400000000300000000022200000400002000000044
03033330003000400000000002220000000030000000000000040033000000000020000000003032220000000000000330002000002200000440002200000004
00333333000000400000200000020000000033300000002200004033000000000002000000000003002000000000000003300000000000000440000220000004
00005033000000040300000000000000000000000000000000000400000000000004000000000000202220000000000000030000000000000040000020000000
00000000050000000033000000030000000004000000000000000000000002000000000000000000000222033000040020050430000000000000000000000000
00000000000000000003300000030000000000000000000033000000000330000000000000000000000022233300000000000040000300044000000000000000
00220030000000000000033000003000000000000000400003330400000030000000000000000000000002200000003000000004000030000000020000022000
00000003300000000000000000003330000440000000000003343300000003000000000000000400000400205000000400000004000000000004033300002000
00000000002240000000000000000330000000000000000000303330300000300000000000000000000000020000000044034400000000000000033300000000
00000000000224000000000030400333400000000000000000000000030220000000000000000000000000022000000044400000440000000000033300000030
00000000000222400000000000440033400000050000000000000000000000004400000000000000400000000000000304400000044040000000003220000000
00000000000002000000000000040200340000002000000300000000000000000040320000000400440000000000500000444000004000000000000022220000
00000000000002000000000000003000000000000003000000000400000000040004000330000000004000000000000000000000000440000000000022220000
00000000000000000000000000000000000000000000000000000000000000004000000330000000000030000000000000000000200044000000000000223000
00000000005000000200000000000040000000400000000000000000000030004400000000000000000003000000000000000000020044000040000000000000
00000000300000000000000000000000000000000000000000000000000000000400000000000000000003300000000000000000000004400004000000000003
00000000000000000003300000000002000000002200000000000000000000000000000000000030000003330000000000000000000004400000000000000000
00003000000000000000000000000200000000002200000000000000330000000300000000000000000000330000300000000000000000000000003302000002
00440300000000020000000000000000000000000200400022000000033000000000030000000040000000003000300044000000000000003300000302200002
00040000000000000040000000000000000000000220000003000000003040000003033000000000000000000303300000000000000000000000000000200002
00034000000000000000000000000000000000000400000000000000300040000000033300000000000000000333300000000000000000000000000000000400
00000000000000000000000000000000000000000000000000000000330000000000043330004004402230000023330004000002000003200000000220000040
03000003000000000032000000000000000000000000000330000000000000000000043330000040300200000000333000000000040003200000000020000004
00030000000000000000003300000000000000000000040000000004000000000000000003300004330020000000003000000300000000220000000000200000
00033000000000000000000300000000000000400000000000000003000000000000000400300000000002000000000000000000000000000030444400020000
30000300000000000000000300003000000000000004000000000000000030044000000000000000000000000000000000000000000000000030000444000000
00000330000000040000000000000000004000000000000000000000000000044440000000000000400000000000000000040000000000000003000244000000
00000033300200000030000000000000300000000000000000000000000000004444000000000000000000000000022000000000000000000000000024000000
00000004034200000000044000000000330000044000000000000000000000000444400000000200000000000000022000000000000000000440000000000400
00000000404200000000000000000000030000044400000000000000000004000444400000000000000000000000002200000000000000000444000000000000
00304000000400000000000000000000003033000440000000000000000000000000044400000000000000000000002200300050000000000000330003350000
00000000000040000220000000000000000003000000000000000000000000004003300040000000004000504000000000000000000005000002000000000000
00000000000000000222000000000000000000440000000000000000004000000000330400003300000000004444000000000005000000000003000000003300
00000000000000000222000300000000000000004000003000000000000402000000030000003333300000000444400000000000002000000004400000003333
00000000000000000022200000000000000000000440000000000000000044200000000000033333330000000000400000003440002200000000400003030333
00000000000000000002200000000000444400000044000000000000000044400000000350000333333000000000000000040004400020000000000000000333
00000400040000000000000000000000034400000044400000000000000004440000000300000000333330000000000000300000440300000000000000000003
00040000000000000000000033300000004400000000000003300003000000440000000033000000033333303002000004030000004000040000000000040000
00000200000300000000000000330000004400000033300000000000000000000000000003000000033333333300000000000000000000000000000020200000
00000000000330000400000000033000004500040003330000000000000004000000000002000000000000003330030000000400000000000000000020222000
00000020000033333000003000000300004400004000000000302000004020000000000000000400000300000333004440000000000000000000200000002200
00000000000033333330000000000300000440000000000000030000000022000000000000000400000300000035000444020000000000000000200030000000
00000000000002233333400000000000000040000050000022030000000002400000000000000000000300000040000000000000000000000000020000000000
00000000000000023333440000000000005000000040000022000000400000000000030020000000000000000000000000000000000300000000002300000000
00000000000000003333340000002004000000004000000000000002443020000000003000000000000004000000000000400000000000000000000030000000
00000000000000003333304000002000000000000000000000000002244442220000000000000000000003300000000000440000000000000000000030500000
00000000004444303333330000000200040000000000400033030002200000220020000000000000000000205222000002200000000000000000000003300000
00030000000004300003330004022000000444400000000044430000000000220002000000020000000000000302000304200000000000000000000000300000
00030000000000400000000000022000000004442000400000030000000000222000020000000000000000000000200030020000000000003000000000300000
00000004002000000000000000022004000000042000000000000003004000000400022004000000000000000000020003000000002200000000000000000000
00000000000000000000000002222000400000004000000000000000000000030000033004400000000000000000000000000000000020000000000000000440
00000000000000040000000002222000000300004402000000000000000000033005043304400005000000000000000300000000000003000000000000000000
00000000000000000000000000222400000000000440000000300004400000033000000433400000000000000200000333000000000000000030000000000000
00000000000000000000000000222200030200000000000000030000300000003030000003300000000000000200000000003000000000400000030000000000
00000000500000000000000000222220000000000000000000000000000000000000000000330004000000030220000000000000000000000000030000000000
00003300040000000000000040022222022000000000500000000000000000000020000000333004000000003000000000000000000000000000033000000330
40000030000400000000000000002222000000000000000500000000000000044002000000033000000000043000000000000000000000000000000000000030
00000000000000000000000030000022000000000000000000000000000000000002000000033300000000040050000000000000000000000000000000000003
00000000000000000000044403000002004000000000000000000000000000000004200500053333000000000000000000000000000000000000000000000000
00000000000000000000050440000000044000000000000000000002200000000000000000002333000000000300000000000020000000000000000000000000
00000000000000000000000000000000000000300000000000044000005000000000000000002003000000000000000000000000000000000000000000000000
00440004000000040004400000000300030000000000000000004400000000000000000000002200000000000000000000000300000400000000000000000000
00000000000000000000000000400000003333000050000000004440020033000000000000000200000044000000003300000330000400000000000005440000
00000000000003000000000000000000000333040000000000000444002232000000000000000020000004000000304000000000000000000000000000440000
00000000000000333000000000000000000333300000000000000000200020000003000000000002200000000000300000000000000000004000000000004000
00000000000043333300050000440000000033300000000000005000220000000000000002200000220000000344432000000000022000404400000000000400
00000000000044333330000000040000400000300000004000040000000000000002000000220000222000000344440000004000000000000000000000003344
00440000000004400333000000000000000000033000004400000000000000000000220000002000002200000000040000000000000000000000000000000444
00044000000400000033000000000000040000000000004440000000000000040000000400002000000022000000004000000000000000000000000000000004
00000000000400003300000000000000044000000000024444400000000030000000003440000200000022000000000300000000000000000000000000000004
00000000000044000004003300000000244000000000004444400000000003000300003300000022000002000000000330000000000000000004000000000000
00000000000004400000000000000000000400000000000000000000000000000200000330000002200002000000000333000000000000000000440000000000
00000000000000440000400000000300000000000000000300000000300000000003004003000000000000000000000333300000000000000000044402000000
00000304040000040000000000004000000000000000002000000000000000000000330000200000000000000000000033330000000000000000000000000000
00000030200000040000000000000000000000000000400000000000000000002222000000020000000000000000000003333300000000000000000000000000
00000000030000000000004000050005000000300000400000000000000000000000003000300000000020000000300000003300000000000000000000540000
00000000030000400000000440000000000200000000050000000000000000000300000300030000000000000200000000200200000000000000000000000000
00020000033000440000020004400000000250204400000000000000000404000033000330033000440004000222000000020204400000330000000000000000
00002300003000004000000000000000000000222400000000000000000400000033000003033000044004000022222000020000440000003030000000000000
00040230200000000000000000000000000000004244000000000054000000003033000003333300004400044000022200022250000000000040000004000222
00040433322000000000002200000000000000000200000000000004400000200333300003333300004400000000002200002200000000003400000004400022
00000003332000000000002240000000000020000000440000000224440000000033300000333300000000000000002200002200000000000444400000400200
00000003333330000000003000000000000000000000000000000000440040000033330000033330000000000000002200000200000000000044440000440000
00000403333330000400000000440000000000000000000000003000320044022044030000033334000000400000000220400000002000000000444400044000
00000400003333400043000000044440000000000000000000000000000000000000030000003334400000000000000000040000002200000000044400004400
00000000000533440000000000000004000000000000000000200000000000000002002000000333000000000000000030044440000000000044004400000440
50000000033003442000000000000000000000000000000032004000000000000000200000000003000000000000000030000440003300040204400000000044
00000000333300344000000000000000000300000000000220000000000000000050022000000003300000000000000430000444000302000200440000000004
00000000033330334000000000000000000000000000040022000000000000000000002220000000330000000000004400000444400000400000440000004004
00000000000030330003000000000400000000000000004000000000030000000000000220000000003333000000000400000444440000000000044400000000
44000000000000000000000040000000000000002000304400000000000000004000040000000000000333330000000440000444440000000000004400000002
00000000000000000040000000000000000003000400000400000000000000004400053300000000000033333000000000000444440000002000000440302042
00000000000000000300000000000000000004000444000403000000000000000000000000000000003002233300000000000044440000000200000000030000
00000000000000000300044200004000000000000044000000030000400000000000000000300000003300233200000000003000444000000220000000030000
00000000000000000000004400000440000000002004003330000000000000000003000030000000000000000320000000000300044000000000000000004444
00000000000000000044000444000044000000000300000000000000000000000000000000000000000000004000000000300000002000000000000400440444
00000000000000000004000044000000000000000300000000000000000000000000000000000000000000000000000044000000400000000004000000044000
00000000000000000000000044400000000000000000500000003000400000000000000000000000300000000000000044400000000000000004400000000000
00000000000000200000000444400000000000000000000000003000000000000000000000000440300000440000000004400000000000000000040000000000
40000000030000022000000044440000000000005040000000000000500002200000040000000040330000000020000000402222200000000000334000000000
00000000000000002200000000444002000050000004400002000000000000200000004000002040030000000020000000002222240000000000330000032000
00000020000400000000000000044000000000000000400002000000000000220000000004000443000000022222000000002222200300000000420000002200
00000022040044000000000000004000005000400000000002000000000000220000000000400000300000000000000003300022200000000003404000400022
00000032200004400000000400044400000000000000000002000020000000022220000050000000030000000004000003445000200004020000004000040042
00000002224000400004000000004440000040000000000000200000000000022222000000000000000000000204400000440000000000042000000000000000
00000000000400440000000000000440003000000000000000000000000000000022250000300000030000000200000000440000000000000030000000000000
00000000000000004400000004000300003344000000000000000000000000000002500000000000000000000500000000000400000000000000000000000000
00030000000000000400000000400030000044440000000000000000300000000502220000000000200000000000000000000000003002000000000000000200
00030000000000000000000000000000330000440000000000004400030000000040020400000000330000000000000000000000033000000400000000000000
00000000000000000000000000000000330000444000000000000000000000000200020044000004430000300000003300000000000000300040000000004000
00000000000000000000000000000000003000000002000000000000000000000003000000003004440000030000000000000000000200030000200000000000
00000000000000000000000000000000000000000000000000030000200000000000000000000000444000003000000000000000000020000000220000000000
00000000000000030000000000000000000000430000000000003303200300000000000000000000044440004300400000000000000050000000000000000000
00000200000000000000000033300000000000403000000000000030000000000000000000000000044440000000300000000000000000004030000000000003
00000200000000000000000033333000000000003000000300000030000004000002200000000000004444000000000000400000000000000000000000000000
00000030000000000000000003333302000000000000000000000000000004400002200000000000000044400000000040000000000000000000000000000000
00000030000000000000000000333302220000000000000000000000003000444002222000050000000004440300000004000000000000000000004404000000
